111111111111111111111
1000000000000000P0001
100000000000000000001
1000000000E0000000001
100000000011000101111
100000000000000100001
111111111111111111111
