111111111111111111111
100000000000000000001
100000000000000000001
1000000000E0000P00001
100000000000000110001
10000C000000000100001
111111111111111111111
