111111111111111111111
1ECCCCCCCCCCCCCCCCCB1
1CCCCCCCCCCCCCCCCCCC1
1CCCCBCCCCCCCCCCCCCB1
1CCCCCCCCCCCCCCCCCCC1
1CCCCBCCCCCCCCCCCCCB1
1CCCCCCCCCCCCCCCCCCC1
1CCCCBCCCCCCCCCCCCCB1
1CCCCCCCCCCCCCCCCCCC1
1CCCCBCCCCCCCCCCCCCB1
1CCCCCCCCCCCCCCCCCCC1
1CCCCBCCCCCCCCCCCCCB1
1CCCCCCCCCCCCCCCCCCC1
1CCCCBCCCCCCCCCCCCCB1
1CCCCCCCCCCCCCCCCCCC1
1CCCCBCCCCCCCCCCCCCB1
1CCCCCCCCCCCCCCCCCCC1
1CCCCCCCCCCCCCCCCCCP1
111111111111111111111
