111111111111111111111
100000000000000000001
100000000000000000001
100000000000000000001
100000000000000000001
100000000000000000001
100000000000000000001
100000000000000000001
100000000000000000001
100000000000000000001
100000000000000000001
100000000000000000001
100011111100000000001
100010000100100000001
101110000100100000001
101000000000100000001
111000000011111110001
100000000000000000CC1
100000000BBBBBBBBBBB1
10000000000000E0000P1
111111111111111111111
