111111111111111111111
1E0000000000000C00001
101001010010000010101
101001001010101010101
1P0000000C00C00000001
101001001010101010101
101001010010000010101
1000000000000000000C1
101001010010101010101
101001001010101010101
1C0000000C00C000000C1
101001001010101010101
101001010010101010101
100000000000000000001
101001010010101010101
101001001010101010101
1C0000000C00C000000C1
101001001010101010101
101001010010101010101
1C00000000000000000C1
111111111111111111111
