111111111111111111111
1P0000000C00000000001
101011111011111101101
1C001000000000000BBB1
111101011101110101111
1C000100C0000C00100C1
101110111011101110101
100000000C00000000001
101110101111101011101
1C00010000000000100C1
111101011111110101111
1C000100C0000C00100C1
101110101111101011101
1000000000000000000E1
111101111011101111111
1C001000C0000C00000C1
101110101111101011101
100000100000001000001
111111101111101111111
1C0000000C000000000C1
111111111111111111111
